type: mettagrid.map_builder.ascii.AsciiMapBuilder.Config
map_data: |-
    #########################
    #.......#.......#.......#
    #.@.....#.......#.....M.#
    #.......#.......#.......#
    ###.#####.#####.#####.###
    #.......#.......#.......#
    #.......#.......#.......#
    #.......#.......#.......#
    ###.#####.#####.#####.###
    #.......#.......#.......#
    #.......#.......#.......#
    #.......#.......#.......#
    #########################

char_to_map_name:
  "#": wall
  ".": empty
  "@": agent.agent
  "M": miner_station
  "S": scout_station
  "A": aligner_station
  "X": scrambler_station
  "C": carbon_extractor
  "O": oxygen_extractor
  "G": germanium_extractor
  "I": silicon_extractor
  "J": charger
  "&": assembler
